┌───┬───┬───┬───┬───┬───┬───┬───┬───┬───┬───┬───┬───┬───┬───┬───┬───┬───┬───┐
│ ▅ │ ▅ │ ▅ │ ▅ │ ▆ │ ▅ │ ▆ │ ▇ │ ▄ │ ▅ │ ▅ │ ▅ │ ▄ │ ▄ │ ▄ │ ▄ │ ▂ │ ▄ │ ▅ │
├───┼───┼───┼───┼───┼───┼───┼───┼───┼───┼───┼───┼───┼───┼───┼───┼───┼───┼───┤
│ ▂ │ ▂ │ ▄ │ ▅ │ ▃ │ ▄ │ ▅ │ ▃ │ ▅ │ ▅ │ ▃ │ ▃ │ ▅ │ ▅ │ ▃ │ ▄ │ ▄ │ ▅ │ ▅ │
├───┼───┼───┼───┼───┼───┼───┼───┼───┼───┼───┼───┼───┼───┼───┼───┼───┼───┼───┤
│ ▅ │ ▅ │ ▅ │ ▂ │ ▅ │ ▆ │ ▄ │ ▅ │ ▆ │ ▂ │ ▅ │ ▅ │ ▅ │ ▄ │ ▆ │ ▃ │ ▄ │ ▄ │ ▄ │
├───┼───┼───┼───┼───┼───┼───┼───┼───┼───┼───┼───┼───┼───┼───┼───┼───┼───┼───┤
│ ▅ │ ▅ │ ▅ │ ▅ │ ▃ │ ▄ │ ▃ │ ▃ │ ▄ │ ▅ │ ▆ │ ▄ │ ▅ │ ▂ │ ▅ │ ▆ │ ▅ │ ▅ │ ▆ │
├───┼───┼───┼───┼───┼───┼───┼───┼───┼───┼───┼───┼───┼───┼───┼───┼───┼───┼───┤
│ ▅ │ ▃ │ ▅ │ ▅ │ ▅ │ ▄ │ ▃ │ ▆ │ ▅ │ ▃ │ ▄ │ ▄ │ ▅ │ ▃ │ ▄ │ ▅ │ ▅ │ ▄ │ ▆ │
├───┼───┼───┼───┼───┼───┼───┼───┼───┼───┼───┼───┼───┼───┼───┼───┼───┼───┼───┤
│ ▄ │ ▃ │ ▆ │ ▅ │ ▆ │ ▅ │ ▅ │ ▅ │ ▅ │ ▆ │ ▆ │ ▅ │ ▅ │ ▄ │ ▇ │ ▄ │ ▆ │ ▇ │ ▆ │
├───┼───┼───┼───┼───┼───┼───┼───┼───┼───┼───┼───┼───┼───┼───┼───┼───┼───┼───┤
│ ▅ │ ▆ │ ▅ │ ▅ │ ▄ │ ▄ │ ▅ │ ▄ │ ▃ │ ▃ │ ▄ │ ▃ │ ▃ │ ▄ │ ▅ │ ▃ │ ▄ │ ▃ │ ▅ │
├───┼───┼───┼───┼───┼───┼───┼───┼───┼───┼───┼───┼───┼───┼───┼───┼───┼───┼───┤
│ ▅ │ ▅ │ ▃ │ ▄ │ ▇ │ ▆ │ ▄ │ ▆ │ ▅ │ ▆ │ ▅ │ ▆ │ ▇ │ ▇ │ ▄ │ ▃ │ ▅ │ ▄ │ ▆ │
├───┼───┼───┼───┼───┼───┼───┼───┼───┼───┼───┼───┼───┼───┼───┼───┼───┼───┼───┤
│ ▅ │ ▄ │ ▃ │ ▄ │ ▄ │ ▄ │ ▄ │ ▄ │ ▃ │ ▃ │ ▆ │ ▅ │ ▅ │ ▃ │ ▂ │ ▅ │ ▅ │ ▃ │ ▄ │
├───┼───┼───┼───┼───┼───┼───┼───┼───┼───┼───┼───┼───┼───┼───┼───┼───┼───┼───┤
│ ▃ │ ▆ │ ▅ │ ▆ │ ▃ │ ▄ │ ▅ │ ▄ │ ▅ │ ▄ │ ▃ │ ▂ │ ▅ │ ▄ │ ▆ │ ▄ │ ▅ │ ▄ │ ▅ │
├───┼───┼───┼───┼───┼───┼───┼───┼───┼───┼───┼───┼───┼───┼───┼───┼───┼───┼───┤
│ ▄ │ ▄ │ ▅ │ ▅ │ ▅ │ ▅ │ ▆ │ ▆ │ ▄ │ ▄ │ ▄ │ ▆ │ ▅ │ ▄ │ ▃ │ ▅ │ ▂ │ ▂ │ ▅ │
├───┼───┼───┼───┼───┼───┼───┼───┼───┼───┼───┼───┼───┼───┼───┼───┼───┼───┼───┤
│ ▅ │ ▄ │ ▄ │ ▅ │ ▄ │ ▄ │ ▅ │ ▆ │ ▅ │ ▄ │ ▆ │ ▆ │ ▄ │ ▆ │ ▅ │ ▆ │ ▅ │ ▆ │ ▆ │
├───┼───┼───┼───┼───┼───┼───┼───┼───┼───┼───┼───┼───┼───┼───┼───┼───┼───┼───┤
│ ▅ │ ▄ │ ▅ │ ▅ │ ▅ │ ▄ │ ▂ │ ▂ │ ▄ │ ▅ │ ▃ │ ▅ │ ▅ │ ▅ │ ▃ │ ▅ │ ▃ │ ▃ │ ▃ │
├───┼───┼───┼───┼───┼───┼───┼───┼───┼───┼───┼───┼───┼───┼───┼───┼───┼───┼───┤
│ ▅ │ ▄ │ ▃ │ ▄ │ ▄ │ ▆ │ ▃ │ ▆ │ ▅ │ ▆ │ ▆ │ ▆ │ ▂ │ ▅ │ ▄ │ ▄ │ ▅ │ ▆ │ ▅ │
├───┼───┼───┼───┼───┼───┼───┼───┼───┼───┼───┼───┼───┼───┼───┼───┼───┼───┼───┤
│ ▃ │ ▆ │ ▅ │ ▅ │ ▄ │ ▅ │ ▆ │ ▆ │ ▄ │ ▃ │ ▃ │ ▆ │ ▆ │ ▅ │ ▄ │ ▂ │ ▄ │ ▆ │ ▅ │
├───┼───┼───┼───┼───┼───┼───┼───┼───┼───┼───┼───┼───┼───┼───┼───┼───┼───┼───┤
│ ▄ │ ▆ │ ▅ │ ▂ │ ▄ │ ▆ │ ▃ │ ▃ │ ▅ │ ▆ │ ▄ │ ▄ │ ▅ │ ▅ │ ▅ │ ▅ │ ▇ │ ▃ │ ▃ │
├───┼───┼───┼───┼───┼───┼───┼───┼───┼───┼───┼───┼───┼───┼───┼───┼───┼───┼───┤
│ ▄ │ ▄ │ ▃ │ ▄ │ ▆ │ ▄ │ ▃ │ ▅ │ ▃ │ ▃ │ ▆ │ ▅ │ ▅ │ ▅ │ ▅ │ ▄ │ ▄ │ ▅ │ ▆ │
├───┼───┼───┼───┼───┼───┼───┼───┼───┼───┼───┼───┼───┼───┼───┼───┼───┼───┼───┤
│ ▄ │ ▄ │ ▅ │ ▃ │ ▃ │ ▅ │ ▆ │ ▅ │ ▄ │ ▄ │ ▄ │ ▂ │ ▃ │ ▃ │ ▃ │ ▆ │ ▄ │ ▃ │ ▅ │
├───┼───┼───┼───┼───┼───┼───┼───┼───┼───┼───┼───┼───┼───┼───┼───┼───┼───┼───┤
│ ▃ │ ▆ │ ▆ │ ▅ │ ▆ │ ▃ │ ▅ │ ▄ │ ▄ │ ▄ │ ▃ │ ▅ │ ▆ │ ▅ │ ▆ │ ▇ │ ▆ │ ▃ │ ▄ │
└───┴───┴───┴───┴───┴───┴───┴───┴───┴───┴───┴───┴───┴───┴───┴───┴───┴───┴───┘
